=============================================================================================================================================
|                               |                                                                                                        *  |
|   *                           |                                                                                                           |
|                               |                   *                                                                                       |
|                                                                                                                                           |
|                                                                            =================           ================================== |
|                          |    |                                            |                                 |                            |
|                          | *  |                                            |                                 |  *                         |
|                          |    |                                            |                                 |                            |
|                  ======================                                    |         |                       |                            |
|                          |    |                                  s         |         |                       |                            |
|                    *     |  * |   *                                        |         |                       |                            |
|                          |    |                                            |         |             *         |                            |
|                  ======================               *                    |         |                       |                            |
|                          |    |                                            |         |                       |                            |
|                          |  * |                                            |         |                       |                            |
|                          |    |                                            |         |                                                    |
|======                                                                      |         |                                                    |
|     |                                                                      |    *    |                                                *   |
|  *  |                                                                      |         |                                                    |
=============================================================================================================================================